1111111111111
10D10000000C1
10000111110D1
1P0011E000001
1111111111111
