111111111111111111111
1C1111C100000000CC001
101C11000000000010001
100000001000111111101
100100001000100000101
100100001000101110101
101110001100101C00101
100001001100001111101
1001C0000000000000001
100100111001111111111
1001001C111100000E111
1P0100000000011111111
111111111111111111111
