11111111111111111111111111
1P00000000C000000000000EC1
11111111111111111111111111
