111111111111111111111
1C1111C100000000CC001
101D110000D0000010001
100000001000111111101
100100001000100000101
100100001000101110101
101110001100101C00101
100001001100001111101
10D1C0000000000000001
1001001110011111D1111
1001001C111100000E111
1P0100000000011111111
111111111111111111111
