1111111111111111111111111111111111
100E00001000000C00000C000000000001
1000000100100000101001000000010101
1DD0000010101010001001000000010101
1PD000000100C0000000000000000000C1
1111111111111111111111111111111111
